2 50 50
5,5,5,5,5,5,5,5,5,5,5,5,5,5,5,5,5,5,5,5,5,5,5,5,5,5,5,5,5,5,5,5,5,5,5,5,5,5,5,5,5,5,5,5,5,5,5,5,5,5,
5,5,5,5,5,5,5,5,5,5,5,5,5,5,5,5,5,5,5,5,5,5,5,5,5,5,5,5,5,5,5,5,5,5,5,5,5,5,5,5,5,5,5,5,5,5,5,5,5,5,
5,5,5,5,5,5,5,5,5,5,5,5,5,5,5,5,5,5,5,5,5,5,5,5,5,5,5,5,5,5,5,5,5,5,5,5,5,5,5,5,5,5,5,5,5,5,5,5,5,5,
5,5,5,5,5,5,5,5,5,5,5,5,5,5,5,5,5,5,5,5,5,5,5,5,5,5,5,5,5,5,5,5,5,5,5,5,5,5,5,5,5,5,5,5,5,5,5,5,5,5,
5,5,5,5,5,5,5,10,8,8,8,8,11,10,8,8,11,5,10,8,8,8,8,8,11,5,5,5,5,5,5,5,5,10,8,8,8,8,8,8,8,8,11,5,5,5,5,5,5,5,
5,5,5,5,5,5,10,9,64,64,64,1,13,6,64,64,7,11,6,43,43,43,43,43,7,8,11,5,5,5,5,5,5,6,43,43,43,43,65,66,67,43,7,11,5,5,5,5,5,5,
5,5,5,5,5,5,6,64,64,44,1,13,5,6,64,64,64,4,6,43,43,43,64,43,43,43,7,8,11,5,5,5,5,6,43,43,43,43,68,69,70,43,43,4,5,5,5,5,5,5,
5,5,5,5,5,10,9,64,64,44,4,5,5,12,3,64,64,4,6,64,71,48,49,49,49,50,43,43,7,11,5,5,5,6,43,43,43,43,48,49,50,43,43,4,5,5,5,5,5,5,
5,5,5,5,5,6,64,64,64,44,7,8,8,8,9,64,64,4,6,64,64,51,61,61,61,53,64,43,43,7,11,5,5,6,43,43,43,43,51,61,53,43,43,4,5,5,5,5,5,5,
5,5,5,5,5,12,2,3,44,44,44,44,44,44,44,44,64,4,6,64,64,54,55,58,62,59,50,64,43,43,4,5,5,12,2,3,43,43,51,61,53,43,43,4,5,5,5,5,5,5,
5,5,5,5,5,5,5,6,44,44,44,44,44,44,44,44,64,4,6,64,64,64,64,54,58,61,59,50,1,2,13,10,8,8,11,6,43,43,51,62,53,43,1,13,5,5,5,5,5,5,
5,5,5,5,5,5,5,6,44,44,65,66,67,43,44,44,1,13,12,3,43,43,64,64,54,58,62,53,4,5,5,6,43,43,4,6,43,43,51,62,53,1,13,5,5,5,5,5,5,5,
5,5,5,5,5,5,5,6,44,64,68,69,70,64,43,44,7,11,5,12,3,43,43,64,64,51,61,53,4,5,5,6,43,43,7,9,43,43,51,62,53,4,5,5,5,5,5,5,5,5,
5,5,5,5,5,5,10,9,43,64,48,49,50,64,43,43,43,7,11,5,6,43,43,64,64,51,61,53,7,8,8,9,64,43,43,43,43,64,51,62,53,7,8,11,5,5,5,5,5,5,
5,5,5,5,5,10,9,64,64,64,51,52,59,50,64,43,43,43,4,5,6,43,43,64,64,51,61,59,49,49,49,49,49,50,43,43,43,64,51,62,53,43,43,4,5,5,5,5,5,5,
5,5,5,5,5,6,64,64,64,64,54,58,61,59,50,64,43,43,7,8,9,64,64,64,64,54,58,61,61,62,61,61,61,59,49,49,49,49,60,62,53,43,43,4,5,5,5,5,5,5,
5,5,5,5,5,6,64,64,64,64,64,54,58,61,53,64,43,43,43,43,64,64,64,64,64,64,54,55,55,55,55,55,58,61,61,61,62,62,62,61,53,64,43,4,5,5,5,5,5,5,
5,5,5,5,5,6,64,1,3,64,64,64,51,61,53,64,64,43,43,64,64,64,1,2,3,64,64,64,64,64,64,64,54,55,55,58,61,62,62,61,59,50,43,4,5,5,5,5,5,5,
5,5,5,5,5,6,1,13,6,64,64,64,51,52,53,64,64,64,64,64,64,64,4,5,12,3,64,64,64,64,64,64,64,64,64,51,61,61,61,61,61,59,50,4,5,5,5,5,5,5,
5,5,5,5,5,12,13,10,9,64,64,64,51,61,53,64,64,64,64,64,64,64,4,5,5,12,3,64,64,64,64,64,64,64,64,54,55,55,55,55,58,62,53,4,5,5,5,5,5,5,
5,5,5,5,5,5,5,6,44,43,64,64,51,61,53,64,64,64,64,64,64,64,7,11,5,5,12,2,2,2,2,2,2,2,2,3,64,64,64,64,51,61,53,4,5,5,5,5,5,5,
5,5,5,5,5,5,10,9,44,43,64,64,51,52,53,64,64,64,64,64,64,64,64,7,11,5,5,5,10,8,8,8,11,5,5,12,2,3,64,64,54,55,56,4,5,5,5,5,5,5,
5,5,5,5,5,5,6,44,43,43,64,64,51,61,53,64,64,64,64,64,64,64,64,64,7,8,8,8,9,44,44,44,7,8,8,11,5,12,3,64,64,71,64,4,5,5,5,5,5,5,
5,5,5,5,5,10,9,43,43,48,49,49,60,61,59,49,49,49,50,64,64,64,64,64,64,44,44,44,44,44,44,44,44,44,44,4,5,5,12,3,64,64,64,4,5,5,5,5,5,5,
5,5,5,5,10,9,43,43,64,51,61,52,61,52,61,61,52,61,59,49,49,50,64,64,64,64,44,64,71,44,44,44,44,44,44,7,11,5,5,12,2,3,64,4,5,5,5,5,5,5,
5,5,5,5,6,64,43,43,64,51,61,57,55,55,55,55,55,58,61,61,61,59,49,49,50,64,64,48,49,50,44,44,44,44,44,44,4,5,5,5,5,12,2,13,5,5,5,5,5,5,
5,5,5,5,6,64,43,43,64,51,52,53,64,64,64,64,64,54,55,55,58,61,61,61,59,50,64,51,61,53,64,64,44,44,44,44,7,11,5,5,5,5,5,5,5,5,5,5,5,5,
5,5,5,5,6,64,64,43,64,54,55,56,64,64,64,64,64,64,64,64,54,55,55,58,61,59,49,60,61,59,49,49,50,44,44,44,64,4,5,5,5,5,5,5,5,5,5,5,5,5,
5,5,5,5,6,64,64,64,64,64,72,64,64,64,64,64,64,64,64,64,64,64,48,60,61,61,61,61,52,61,61,61,59,50,44,44,44,7,11,5,5,5,5,5,5,5,5,5,5,5,
5,5,5,5,6,64,64,64,1,2,2,3,64,64,64,64,64,64,64,64,64,64,51,61,61,57,55,55,55,55,58,61,52,53,64,44,44,64,4,5,5,5,5,5,5,5,5,5,5,5,
5,5,5,5,6,64,64,1,13,5,5,12,2,2,2,2,2,2,3,43,64,48,60,52,57,56,64,64,64,64,54,58,61,53,64,44,44,64,4,5,5,5,5,5,5,5,5,5,5,5,
5,5,5,5,12,2,2,13,10,8,8,11,5,5,5,5,5,10,9,43,64,51,61,61,53,64,64,64,64,64,64,51,61,53,64,43,44,44,7,8,11,5,5,5,5,5,5,5,5,5,
5,5,5,5,5,5,5,10,9,43,43,7,8,8,8,8,8,9,43,64,48,60,52,57,56,64,64,64,64,64,64,51,61,53,64,43,43,44,44,64,4,5,5,5,5,5,5,5,5,5,
5,5,5,5,5,5,5,6,43,43,43,64,64,64,64,64,64,64,64,64,51,61,61,53,64,64,64,64,64,64,48,60,52,53,64,43,43,43,43,64,7,11,5,5,5,5,5,5,5,5,
5,5,5,5,5,5,5,6,43,43,64,64,64,64,64,64,64,64,48,49,60,61,57,56,64,64,64,64,64,64,51,61,57,56,64,43,43,43,43,43,64,4,5,5,5,5,5,5,5,5,
5,5,5,5,5,5,5,12,3,43,64,64,64,64,64,64,64,64,51,61,52,57,56,64,64,1,3,64,64,64,51,61,53,64,64,64,64,64,43,43,43,4,5,5,5,5,5,5,5,5,
5,5,5,5,5,5,5,5,12,3,64,64,64,64,64,64,64,64,51,61,57,56,64,64,64,4,6,64,64,64,51,61,53,64,64,65,66,67,64,43,43,4,5,5,5,5,5,5,5,5,
5,5,5,5,5,5,5,5,5,6,64,64,64,64,46,64,64,64,51,52,53,64,64,64,64,4,6,64,64,64,51,52,59,50,64,68,69,70,64,64,64,7,11,5,5,5,5,5,5,5,
5,5,5,5,5,5,5,5,5,6,64,64,39,40,47,41,42,64,51,61,53,64,64,64,1,13,6,64,64,64,51,61,61,59,49,49,49,50,64,64,64,64,4,5,5,5,5,5,5,5,
5,5,5,5,5,5,5,5,10,9,64,64,64,48,49,50,64,48,60,61,53,64,64,64,4,5,6,64,64,64,54,58,61,52,61,61,52,53,64,64,64,64,4,5,5,5,5,5,5,5,
5,5,5,5,5,5,5,5,6,64,64,64,64,51,61,59,49,60,61,57,64,64,64,64,4,5,6,64,64,64,64,54,55,55,55,55,55,56,64,64,64,64,4,5,5,5,5,5,5,5,
5,5,5,5,5,5,5,5,12,3,64,64,64,51,61,61,61,61,57,56,64,64,64,1,13,5,12,3,64,64,64,64,64,64,64,64,64,64,64,64,64,1,13,5,5,5,5,5,5,5,
5,5,5,5,5,5,5,5,5,12,3,64,64,54,55,55,55,55,64,64,64,64,1,13,5,5,5,12,3,64,64,64,64,64,64,64,64,64,64,64,1,13,5,5,5,5,5,5,5,5,
5,5,5,5,5,5,5,5,5,5,12,2,3,64,64,64,64,1,2,2,2,2,13,5,5,5,5,5,12,2,2,2,2,2,2,2,2,2,2,2,13,5,5,5,5,5,5,5,5,5,
5,5,5,5,5,5,5,5,5,5,5,5,12,2,2,2,2,13,5,5,5,5,5,5,5,5,5,5,5,5,5,5,5,5,5,5,5,5,5,5,5,5,5,5,5,5,5,5,5,5,
5,5,5,5,5,5,5,5,5,5,5,5,5,5,5,5,5,5,5,5,5,5,5,5,5,5,5,5,5,5,5,5,5,5,5,5,5,5,5,5,5,5,5,5,5,5,5,5,5,5,
5,5,5,5,5,5,5,5,5,5,5,5,5,5,5,5,5,5,5,5,5,5,5,5,5,5,5,5,5,5,5,5,5,5,5,5,5,5,5,5,5,5,5,5,5,5,5,5,5,5,
5,5,5,5,5,5,5,5,5,5,5,5,5,5,5,5,5,5,5,5,5,5,5,5,5,5,5,5,5,5,5,5,5,5,5,5,5,5,5,5,5,5,5,5,5,5,5,5,5,5,
5,5,5,5,5,5,5,5,5,5,5,5,5,5,5,5,5,5,5,5,5,5,5,5,5,5,5,5,5,5,5,5,5,5,5,5,5,5,5,5,5,5,5,5,5,5,5,5,5,5,
5,5,5,5,5,5,5,5,5,5,5,5,5,5,5,5,5,5,5,5,5,5,5,5,5,5,5,5,5,5,5,5,5,5,5,5,5,5,5,5,5,5,5,5,5,5,5,5,5,5,
0,0,0,0,0,0,0,0,0,0,0,0,0,0,0,0,0,0,0,0,0,0,0,0,0,0,0,0,0,0,0,0,0,0,0,0,0,0,0,0,0,0,0,0,0,0,0,0,0,0,
0,0,0,0,0,0,0,0,0,0,0,0,0,0,0,0,0,0,0,0,0,0,0,0,0,0,0,0,0,0,0,0,0,0,0,0,0,0,0,0,0,0,0,0,0,0,0,0,0,0,
0,0,0,0,0,0,0,0,0,0,0,0,0,0,0,0,0,0,0,0,0,0,0,0,0,0,0,0,0,0,0,0,0,0,0,0,0,0,0,0,0,0,0,0,0,0,0,0,0,0,
0,0,0,0,0,0,0,0,0,0,0,0,0,0,0,0,0,0,0,0,0,0,0,0,0,0,0,0,0,0,0,0,0,0,0,0,0,0,0,0,0,0,0,0,0,0,0,0,0,0,
0,0,0,0,0,0,0,0,0,0,0,0,0,0,0,0,0,0,0,0,0,0,0,0,0,0,0,0,0,0,0,0,0,0,0,0,0,0,0,0,0,0,0,0,0,0,0,0,0,0,
0,0,0,0,0,0,0,0,43,43,0,0,0,0,43,43,0,0,0,0,0,0,0,0,0,0,0,0,0,0,0,0,0,0,0,0,0,0,0,0,0,0,0,0,0,0,0,0,0,0,
0,0,0,0,0,0,0,43,43,0,0,0,0,0,43,43,43,0,0,0,0,0,0,0,0,0,0,0,0,0,0,0,0,0,0,0,0,0,0,0,0,0,0,0,0,0,0,0,0,0,
0,0,0,0,0,0,0,43,43,0,0,0,0,0,0,43,43,0,0,0,0,0,0,0,0,0,0,0,0,0,0,0,0,0,0,0,0,0,0,0,0,0,0,0,0,0,0,0,0,0,
0,0,0,0,0,0,43,43,43,0,0,0,0,0,0,43,43,0,0,0,0,0,0,0,0,0,0,0,0,0,0,0,0,0,0,0,0,0,0,0,0,0,0,0,0,0,0,0,0,0,
0,0,0,0,0,0,0,0,0,0,0,0,0,0,0,0,43,0,0,63,0,0,0,0,0,0,0,0,0,0,0,0,0,0,0,0,0,0,0,0,0,0,0,0,0,0,0,0,0,0,
0,0,0,0,0,0,0,0,0,0,0,0,0,0,0,0,43,0,0,63,63,63,0,0,0,0,0,0,0,0,0,0,0,0,0,0,0,0,0,0,0,0,0,0,0,0,0,0,0,0,
0,0,0,0,0,0,0,0,0,0,0,0,0,0,0,0,0,0,0,0,0,0,63,0,0,0,0,0,0,0,0,0,0,0,0,0,0,0,0,0,0,0,0,0,0,0,0,0,0,0,
0,0,0,0,0,0,0,0,0,0,0,0,0,0,0,0,0,0,0,0,0,0,0,0,0,0,0,0,0,0,0,0,0,0,0,0,0,0,0,0,0,0,0,0,0,0,0,0,0,0,
0,0,0,0,0,0,0,0,0,0,0,0,0,0,0,0,0,0,0,0,0,0,0,0,0,0,0,0,0,0,0,0,0,0,0,0,0,0,0,0,0,0,0,0,0,0,0,0,0,0,
0,0,0,0,0,0,0,63,0,0,0,0,0,0,0,0,0,0,0,0,0,0,0,0,0,0,0,0,0,0,0,0,0,0,0,0,0,0,0,0,0,0,0,0,0,0,0,0,0,0,
0,0,0,0,0,0,63,63,0,0,0,0,0,0,0,0,0,0,0,0,0,0,0,0,0,0,0,0,0,0,0,0,0,0,0,0,0,0,0,0,0,0,0,0,0,0,0,0,0,0,
0,0,0,0,0,0,63,63,63,63,0,0,0,0,0,0,0,0,0,0,0,0,0,0,0,0,0,0,0,0,0,0,0,0,0,0,0,0,0,0,0,0,0,0,0,0,0,0,0,0,
0,0,0,0,0,0,63,0,0,63,0,0,0,0,0,0,0,0,0,0,0,0,0,0,0,63,63,63,63,0,0,0,0,0,0,0,0,0,0,0,0,0,0,0,0,0,0,0,0,0,
0,0,0,0,0,0,0,0,0,63,0,0,0,0,0,0,0,0,0,0,0,0,0,0,0,0,63,63,63,63,0,0,63,63,63,0,0,0,0,0,0,0,0,0,0,0,0,0,0,0,
0,0,0,0,0,0,0,0,0,63,0,0,0,0,0,0,0,0,0,0,0,0,0,0,0,0,0,63,63,63,63,63,63,63,63,0,0,0,0,0,0,0,0,0,0,0,0,0,0,0,
0,0,0,0,0,0,0,0,0,0,0,0,0,0,0,0,0,0,0,0,0,0,0,0,0,0,0,0,0,0,0,0,0,0,0,0,63,63,0,0,0,0,0,0,0,0,0,0,0,0,
0,0,0,0,0,0,0,0,0,0,0,0,0,0,0,0,0,0,0,0,0,0,0,0,0,0,0,0,0,0,0,0,0,0,0,0,0,0,63,63,0,0,0,0,0,0,0,0,0,0,
0,0,0,0,0,0,0,0,0,0,0,0,0,0,0,0,0,0,0,0,0,0,0,0,0,0,0,0,0,0,0,0,0,0,0,0,0,0,0,63,63,0,63,0,0,0,0,0,0,0,
0,0,0,0,0,0,0,0,0,0,0,0,0,0,0,0,0,0,0,0,0,0,0,0,0,0,0,0,0,0,0,0,0,0,0,0,0,0,0,0,63,63,63,0,0,0,0,0,0,0,
0,0,0,0,0,0,0,0,0,0,0,0,0,0,0,0,0,0,0,0,0,0,0,0,0,0,0,0,0,0,0,0,0,0,0,0,0,0,0,0,0,0,63,0,0,0,0,0,0,0,
0,0,0,0,0,63,0,0,0,0,0,0,0,0,0,0,0,0,0,0,0,0,0,0,0,0,0,0,0,0,0,0,0,0,0,0,0,0,0,0,0,0,0,0,0,0,0,0,0,0,
0,0,0,0,0,63,0,0,0,0,0,0,0,0,63,63,0,0,0,0,0,0,0,0,0,0,0,0,0,0,0,0,0,0,0,0,0,0,0,0,0,0,0,0,0,0,0,0,0,0,
0,0,0,0,0,63,63,0,0,0,0,0,0,63,63,63,63,0,63,0,0,0,0,0,0,0,0,0,0,0,0,0,0,0,0,0,0,0,0,0,0,0,0,0,0,0,0,0,0,0,
0,0,0,0,0,43,63,63,63,0,0,63,63,63,63,63,63,63,63,63,0,0,0,0,0,0,0,0,0,0,0,0,0,0,0,0,0,0,0,0,0,0,0,0,0,0,0,0,0,0,
0,0,0,0,0,43,63,63,0,0,0,0,63,63,63,63,63,63,63,63,0,0,0,0,0,0,0,0,0,0,0,0,0,0,0,0,0,0,0,0,0,0,0,0,0,0,0,0,0,0,
0,0,0,0,0,43,63,0,0,0,0,0,0,0,0,0,0,0,0,0,0,0,0,0,0,0,0,0,63,0,0,0,0,0,0,0,0,0,0,0,0,0,0,0,0,0,0,0,0,0,
0,0,0,0,0,0,0,0,0,0,0,0,0,0,0,0,0,0,0,0,0,0,0,0,0,0,63,63,63,0,0,0,0,0,0,0,0,0,0,0,0,0,0,0,0,0,0,0,0,0,
0,0,0,0,0,0,0,0,0,0,0,0,0,0,0,0,0,0,0,0,0,0,0,0,0,63,63,63,63,0,0,0,0,0,0,0,0,0,0,0,0,0,0,0,0,0,0,0,0,0,
0,0,0,0,0,0,0,0,0,0,0,0,16,17,18,19,20,0,0,0,0,0,0,0,63,63,63,63,63,0,0,0,0,0,0,0,0,0,0,0,0,0,0,0,0,0,0,0,0,0,
0,0,0,0,0,0,0,0,0,0,0,0,21,22,23,24,25,0,0,0,0,0,0,0,63,63,63,63,63,0,0,0,0,0,0,0,0,0,0,0,0,0,0,0,0,0,0,0,0,0,
0,0,0,0,0,0,0,0,0,0,0,0,26,27,28,29,30,0,0,0,0,0,0,63,63,0,0,63,63,0,0,0,0,0,0,0,0,0,0,0,0,0,0,0,0,0,0,0,0,0,
0,0,0,0,0,0,0,0,0,0,0,0,31,32,45,33,34,0,0,0,0,0,63,63,63,0,0,63,63,0,0,0,0,0,0,0,0,0,0,0,0,0,0,0,0,0,0,0,0,0,
0,0,0,0,0,0,0,0,0,0,0,0,35,36,0,37,38,0,0,0,0,0,0,63,63,0,0,63,63,0,0,0,0,0,0,0,0,0,0,0,63,0,0,0,0,0,0,0,0,0,
0,0,0,0,0,0,0,0,0,0,63,0,0,0,0,0,0,0,0,0,0,0,63,63,0,0,0,44,44,63,0,0,0,0,0,0,0,0,0,63,63,44,0,0,0,0,0,0,0,0,
0,0,0,0,0,0,0,0,0,0,63,0,0,0,0,0,0,0,0,0,0,0,63,63,0,0,0,44,44,63,0,0,0,0,0,0,0,0,63,63,63,44,0,0,0,0,0,0,0,0,
0,0,0,0,0,0,0,0,0,63,63,63,0,0,0,0,0,0,0,0,0,0,63,63,0,0,0,44,44,63,63,0,0,0,0,0,0,0,63,63,63,44,0,0,0,0,0,0,0,0,
0,0,0,0,0,0,0,0,0,0,63,63,63,0,0,0,0,0,0,0,0,63,63,0,0,0,0,0,44,44,63,63,63,63,63,63,63,63,63,63,44,0,0,0,0,0,0,0,0,0,
0,0,0,0,0,0,0,0,0,0,0,63,63,0,0,0,0,0,0,63,63,63,0,0,0,0,0,0,0,44,44,44,44,44,44,44,44,44,44,44,0,0,0,0,0,0,0,0,0,0,
0,0,0,0,0,0,0,0,0,0,0,0,0,63,63,63,63,0,0,0,0,0,0,0,0,0,0,0,0,0,0,0,0,0,0,0,0,0,0,0,0,0,0,0,0,0,0,0,0,0,
0,0,0,0,0,0,0,0,0,0,0,0,0,0,0,0,0,0,0,0,0,0,0,0,0,0,0,0,0,0,0,0,0,0,0,0,0,0,0,0,0,0,0,0,0,0,0,0,0,0,
0,0,0,0,0,0,0,0,0,0,0,0,0,0,0,0,0,0,0,0,0,0,0,0,0,0,0,0,0,0,0,0,0,0,0,0,0,0,0,0,0,0,0,0,0,0,0,0,0,0,
0,0,0,0,0,0,0,0,0,0,0,0,0,0,0,0,0,0,0,0,0,0,0,0,0,0,0,0,0,0,0,0,0,0,0,0,0,0,0,0,0,0,0,0,0,0,0,0,0,0,
0,0,0,0,0,0,0,0,0,0,0,0,0,0,0,0,0,0,0,0,0,0,0,0,0,0,0,0,0,0,0,0,0,0,0,0,0,0,0,0,0,0,0,0,0,0,0,0,0,0,
0,0,0,0,0,0,0,0,0,0,0,0,0,0,0,0,0,0,0,0,0,0,0,0,0,0,0,0,0,0,0,0,0,0,0,0,0,0,0,0,0,0,0,0,0,0,0,0,0,0,
0,0,0,0,0,0,0,0,0,0,0,0,0,0,0,0,0,0,0,0,0,0,0,0,0,0,0,0,0,0,0,0,0,0,0,0,0,0,0,0,0,0,0,0,0,0,0,0,0,0